+----------------+
\               $|
|                |
|                \
|              s |
+----------------+