+----------------+
\               $|
|             p  |
|                \
|                |
+----------------+