+----------+
|         $|
|          |
\          |
|          |
|         O|
+----------+