+----------+
|$ t       |
           |
|          \
|          |
+----------+