+----------+
|$         |
O          .
|         t|
+----------+