+----------+
|$         |
           |
|c         \
|          |
+----------+