+-----------+
|$          |
            |
|     p     \
|           |
|           |
+-----------+