+-----------------------------+
|           +====||          ;|
| ==+ ===+       +===+  +===+ |
|  ||   ||  +=+     ||  || ||=|
|=====+ ||  +=====+ ++  ++$||=|
|    || ||       ||        || .
  ++ || +======+ +==========+ |
| || ||    || ||       ||     |
| +===+ ++ ++ +===+  ===+  ===|
|       ||       ||           |
+-----------------------------+