+----------------+
\               $|
|                |
|                \
|                |
+----------------+